-제목
-플레이어 이름 ; 시간 ; 점수
-플레이목표설명
.S.S..S.S..
11111111111
1.........1
1.........1
1.........1
1.........1
1..P..s...1
1.........1
1..s..s...1
1....s....1
11111111111

