-제목
-플레이어 이름 ; 시간 ; 점수
-플레이목표설명
........a..
11111111111
1.........1
1.........1
1.........1
1.........1
1..P.A....1
1.........1
1.........1
1.........1
11111111111

