-제목
-플레이어 이름 ; 시간 ; 점수
-플레이목표설명
........S..
11111111111
1.........1
1.........1
1.........1
1.........1
1..P..s...1
1.........1
1.........1
1.........1
11111111111

